-1 1 -1 2 -1 4 
0 -1 -1 3 -1 5 
-1 3 0 -1 -1 6 
2 -1 1 -1 -1 7 
-1 5 -1 6 0 -1 
4 -1 -1 7 1 -1 
-1 7 4 -1 2 -1 
6 -1 5 -1 3 -1 
